    _   __ ______ _       __     __     ______ _    __ ______ __ 
   / | / // ____/| |     / /    / /    / ____/| |  / // ____// / 
  /  |/ // __/   | | /| / /    / /    / __/   | | / // __/  / /  
 / /|  // /___   | |/ |/ /    / /___ / /___   | |/ // /___ / /___
/_/ |_//_____/   |__/|__/    /_____//_____/   |___//_____//_____/
                                                                 
                                                                 